MMMMMMMMMMMMMMMMMMMMMMMMMMMMMMMMMMMMMMMM
MMOOMMMOOOMMMMMOOOOOOOOOOOOOOOOOOOOOOMMM
MMMOMMMMMOMMMMMOMMMMMMMMMMMMMMMMMMMMMMMM
MMMOOOOOOOOOOOOOOOOOOOOOOOOOOOOOOOOOOOOM
MMMOMMMMMMMMMMMMMMMMMMMMMMMMMMMMMMMOMMMM
MMOOMMMMMMOOOOOOOOOOOOOOOOOOOOOOOOOOMMMM
MMOMMMMMMMMMMMMMMMMMMMMMMMMMMMMMMMMMMMMM
MMOOOOOOOOOOOOOOOOOOOOOOOOOOOOOOOOOOMMMM
MMMMMMMMMMMMMMMMMMMMMMMMMMMMMMMMMMMMMMMM